6 8
17 18
0 0 0 0 0 0 26 31 31 31 28 0 0 0 0 0 0 
0 0 0 0 0 26 29 15 15 15 27 28 0 0 0 0 0 
0 0 0 0 26 29 5 10 10 10 5 27 28 0 0 0 0 
0 0 0 26 29 20 10 10 10 10 10 20 27 28 0 0 0 
0 0 26 29 5 10 10 10 10 10 10 10 5 27 28 0 0 
0 26 29 5 10 10 10 10 10 10 10 10 10 5 27 28 0 
26 29 20 10 10 10 10 10 10 10 10 10 10 10 20 27 28 
17 5 10 10 10 10 10 1 6 11 10 10 10 10 10 5 17 
32 10 10 10 10 10 1 9 24 4 11 10 10 10 10 10 32 
32 10 10 10 10 10 3 19 24 14 13 10 10 10 10 10 32 
32 10 10 10 10 10 20 3 8 13 20 10 10 10 10 10 32 
27 28 10 10 10 10 10 5 5 5 10 10 10 10 10 26 29 
0 27 28 10 10 10 10 10 10 10 10 10 10 10 26 29 0 
0 0 27 28 10 10 10 10 10 10 10 10 10 26 29 0 0 
0 0 0 27 28 10 10 10 10 10 10 10 26 29 0 0 0 
0 0 0 0 27 28 10 10 10 10 10 26 29 0 0 0 0 
0 0 0 0 0 27 28 10 10 10 26 29 0 0 0 0 0 
0 0 0 0 0 0 27 31 31 31 29 0 0 0 0 0 0 
0 0 0 0 0 0 1 1 1 1 1 0 0 0 0 0 0 
0 0 0 0 0 1 1 1 1 1 1 1 0 0 0 0 0 
0 0 0 0 1 1 1 0 0 0 1 1 1 0 0 0 0 
0 0 0 1 1 1 0 0 0 0 0 1 1 1 0 0 0 
0 0 1 1 1 0 0 0 0 0 0 0 1 1 1 0 0 
0 1 1 1 0 0 0 0 0 0 0 0 0 1 1 1 0 
1 1 1 0 0 0 0 0 0 0 0 0 0 0 1 1 1 
1 1 0 0 0 0 0 1 1 1 0 0 0 0 0 1 1 
1 0 0 0 0 0 1 1 1 1 1 0 0 0 0 0 1 
1 0 0 0 0 0 1 1 1 1 1 0 0 0 0 0 1 
1 0 0 0 0 0 1 1 1 1 1 0 0 0 0 0 1 
1 1 0 0 0 0 0 1 1 1 0 0 0 0 0 1 1 
1 1 1 0 0 0 0 0 0 0 0 0 0 0 1 1 1 
1 1 1 1 0 0 0 0 0 0 0 0 0 1 1 1 1 
1 1 1 1 1 0 0 0 0 0 0 0 1 1 1 1 1 
1 1 1 1 1 1 0 0 0 0 0 1 1 1 1 1 1 
1 1 1 1 1 1 1 0 0 0 1 1 1 1 1 1 1 
1 1 1 1 1 1 1 1 1 1 1 1 1 1 1 1 1 

12
2 7 2 8 2 9
8 1 9 1 10 1
8 16 9 16 10 16
16 7 16 8 16 9

3
2 7 2 8 2 9

60
