14 8
17 16
26 23 23 23 23 23 23 31 31 31 23 23 23 23 23 23 28 
17 5 20 5 5 20 5 15 15 15 5 20 5 5 20 5 17 
17 10 10 10 10 10 10 10 10 10 10 10 10 10 10 10 17 
17 10 10 10 10 10 10 10 10 10 10 10 10 10 10 10 17 
17 10 10 10 10 10 10 10 10 10 10 10 10 10 10 10 17 
17 10 10 10 10 10 10 10 10 10 10 10 10 10 10 10 17 
17 10 10 10 10 10 10 10 10 10 10 10 10 10 10 10 17 
32 10 10 10 10 10 10 10 10 10 10 10 10 10 10 10 32 
32 10 10 10 10 10 10 10 10 10 10 10 10 10 10 10 32 
17 10 10 10 10 10 10 10 10 10 10 10 10 10 10 10 17 
17 10 10 10 10 10 10 10 10 10 10 10 10 10 10 10 17 
17 10 10 10 10 10 10 10 10 10 10 10 10 10 10 10 17 
17 10 10 10 10 10 10 10 10 10 10 10 10 10 10 10 17 
17 10 10 10 10 10 10 10 10 10 10 10 10 10 10 10 17 
17 10 10 10 10 10 10 10 10 10 10 10 10 10 10 10 17 
27 23 23 31 31 23 23 23 23 23 23 23 31 31 23 23 29 
1 1 1 1 1 1 1 1 1 1 1 1 1 1 1 1 1 
1 1 1 1 1 1 1 1 1 1 1 1 1 1 1 1 1 
1 0 0 0 0 0 0 0 0 0 0 0 0 0 0 0 1 
1 0 0 0 0 0 0 0 0 0 0 0 0 0 0 0 1 
1 0 0 0 0 0 0 0 0 0 0 0 0 0 0 0 1 
1 0 0 0 0 0 0 0 0 0 0 0 0 0 0 0 1 
1 0 0 0 0 0 0 0 0 0 0 0 0 0 0 0 1 
1 0 0 0 0 0 0 0 0 0 0 0 0 0 0 0 1 
1 0 0 0 0 0 0 0 0 0 0 0 0 0 0 0 1 
1 0 0 0 0 0 0 0 0 0 0 0 0 0 0 0 1 
1 0 0 0 0 0 0 0 0 0 0 0 0 0 0 0 1 
1 0 0 0 0 0 0 0 0 0 0 0 0 0 0 0 1 
1 0 0 0 0 0 0 0 0 0 0 0 0 0 0 0 1 
1 0 0 0 0 0 0 0 0 0 0 0 0 0 0 0 1 
1 0 0 0 0 0 0 0 0 0 0 0 0 0 0 0 1 
1 1 1 1 1 1 1 1 1 1 1 1 1 1 1 1 1 

11
7 1
8 1
2 7
2 8
2 9
7 15
8 15
14 3
14 4
14 12
14 13

3
2 7
2 8
2 9

25
