18 6
16 20
0 0 0 0 0 26 23 31 31 23 28 0 0 0 0 0 
0 0 0 0 0 17 5 15 15 5 17 0 0 0 0 0 
26 23 23 23 23 29 10 10 10 10 27 23 23 23 23 28 
17 5 20 5 20 5 10 10 10 10 5 20 5 20 5 17 
17 10 10 10 10 10 10 10 10 10 10 10 10 10 10 17 
32 10 10 10 10 10 10 10 10 10 10 10 10 10 10 32 
17 10 10 10 10 10 10 10 10 10 10 10 10 10 10 17 
27 23 23 23 23 28 10 10 10 10 26 23 23 23 23 29 
26 23 23 23 23 29 10 10 10 10 27 23 23 23 23 28 
17 5 20 5 20 5 10 10 10 10 5 20 5 20 5 17 
17 10 10 10 10 10 10 10 10 10 10 10 10 10 10 17 
32 10 10 10 10 10 10 10 10 10 10 10 10 10 10 32 
17 10 10 10 10 10 10 10 10 10 10 10 10 10 10 17 
27 23 23 23 23 28 10 10 10 10 26 23 23 23 23 29 
26 23 23 23 23 29 10 10 10 10 27 23 23 23 23 28 
17 5 20 5 20 5 10 10 10 10 5 20 5 20 5 17 
17 10 10 10 10 10 10 10 10 10 10 10 10 10 10 17 
32 10 10 10 10 10 10 10 10 10 10 10 10 10 10 32 
17 10 10 10 10 10 10 10 10 10 10 10 10 10 10 17 
27 23 23 23 23 23 23 23 23 23 23 23 23 23 23 29 
0 0 0 0 0 1 1 1 1 1 1 0 0 0 0 0 
0 0 0 0 0 1 1 1 1 1 1 0 0 0 0 0 
1 1 1 1 1 1 0 0 0 0 1 1 1 1 1 1 
1 1 1 1 1 1 0 0 0 0 1 1 1 1 1 1 
1 0 0 0 0 0 0 0 0 0 0 0 0 0 0 1 
1 0 0 0 0 0 0 0 0 0 0 0 0 0 0 1 
1 0 0 0 0 0 0 0 0 0 0 0 0 0 0 1 
1 1 1 1 1 1 0 0 0 0 1 1 1 1 1 1 
1 1 1 1 1 1 0 0 0 0 1 1 1 1 1 1 
1 1 1 1 1 1 0 0 0 0 1 1 1 1 1 1 
1 0 0 0 0 0 0 0 0 0 0 0 0 0 0 1 
1 0 0 0 0 0 0 0 0 0 0 0 0 0 0 1 
1 0 0 0 0 0 0 0 0 0 0 0 0 0 0 1 
1 1 1 1 1 1 0 0 0 0 1 1 1 1 1 1 
1 1 1 1 1 1 0 0 0 0 1 1 1 1 1 1 
1 1 1 1 1 1 0 0 0 0 1 1 1 1 1 1 
1 0 0 0 0 0 0 0 0 0 0 0 0 0 0 1 
1 0 0 0 0 0 0 0 0 0 0 0 0 0 0 1 
1 0 0 0 0 0 0 0 0 0 0 0 0 0 0 1 
1 1 1 1 1 1 1 1 1 1 1 1 1 1 1 1 
8
2 7
2 8
5 1
11 1
17 1
5 14
11 14
17 14

2
2 7
2 8

35