21 13
27 23
0 0 0 0 0 0 0 0 0 0 26 23 31 31 31 23 28 0 0 0 0 0 0 0 0 0 0 
0 0 0 0 0 0 0 0 0 0 17 5 15 15 15 5 17 0 0 0 0 0 0 0 0 0 0 
26 23 23 31 31 31 23 23 23 23 29 10 10 10 10 10 27 23 23 23 23 31 31 31 23 23 28 
17 5 5 15 15 15 5 5 5 5 5 10 10 10 10 10 5 5 5 5 5 15 15 15 5 5 17 
17 10 10 10 10 10 10 10 10 10 10 10 10 10 10 10 10 10 10 10 10 10 10 10 10 10 17 
17 10 10 10 10 10 10 10 10 10 10 10 10 10 10 10 10 10 10 10 10 10 10 10 10 10 17 
17 10 10 10 10 10 10 1 6 6 6 6 6 6 6 6 6 6 6 11 10 10 10 10 10 10 17 
32 10 10 10 10 10 10 2 24 24 24 24 24 24 24 24 24 24 24 12 10 10 10 10 10 10 32 
32 10 10 10 10 10 10 2 24 24 24 24 24 24 24 24 24 24 24 12 10 10 10 10 10 10 32 
17 10 10 10 10 10 10 2 24 24 24 24 24 24 24 24 24 24 24 12 10 10 10 10 10 10 17 
17 10 10 10 10 10 10 2 24 24 24 24 24 24 24 24 24 24 24 12 10 10 10 10 10 10 17 
27 23 28 10 10 10 1 9 14 8 8 8 8 8 8 8 8 8 19 4 11 10 10 10 26 23 29 
0 0 17 10 10 10 2 24 12 5 5 5 15 15 15 5 5 5 2 24 12 10 10 10 17 0 0 
0 0 17 10 10 10 2 24 12 10 10 10 10 10 10 10 10 10 2 24 12 10 10 10 17 0 0 
0 0 17 10 10 10 3 8 13 10 10 10 10 10 10 10 10 10 3 8 13 10 10 10 17 0 0 
0 0 17 10 10 10 5 5 5 10 10 10 10 10 10 10 10 10 5 5 5 10 10 10 17 0 0 
0 0 32 10 10 10 10 10 10 10 10 10 30 30 30 10 10 10 10 10 10 10 10 10 32 0 0 
0 0 32 10 10 10 10 10 10 10 10 10 30 30 30 10 10 10 10 10 10 10 10 10 32 0 0 
0 0 17 10 10 10 10 10 10 10 10 10 25 25 25 10 10 10 10 10 10 10 10 10 17 0 0 
0 0 27 23 23 23 23 23 28 10 10 10 10 10 10 10 10 10 26 23 23 23 23 23 29 0 0 
0 0 0 0 0 0 0 0 17 10 10 10 10 10 10 10 10 10 17 0 0 0 0 0 0 0 0 
0 0 0 0 0 0 0 0 17 10 10 10 10 10 10 10 10 10 17 0 0 0 0 0 0 0 0 
0 0 0 0 0 0 0 0 27 23 23 23 23 23 23 23 23 23 29 0 0 0 0 0 0 0 0 
1 1 1 1 1 1 1 1 1 1 1 1 1 1 1 1 1 1 1 1 1 1 1 1 1 1 1 
1 1 1 1 1 1 1 1 1 1 1 1 1 1 1 1 1 1 1 1 1 1 1 1 1 1 1 
1 1 1 1 1 1 1 1 1 1 1 0 0 0 0 0 1 1 1 1 1 1 1 1 1 1 1 
1 1 1 1 1 1 1 1 1 1 1 0 0 0 0 0 1 1 1 1 1 1 1 1 1 1 1 
1 0 0 0 0 0 0 0 0 0 0 0 0 0 0 0 0 0 0 0 0 0 0 0 0 0 1 
1 0 0 0 0 0 0 0 0 0 0 0 0 0 0 0 0 0 0 0 0 0 0 0 0 0 1 
1 0 0 0 0 0 0 1 1 1 1 1 1 1 1 1 1 1 1 1 0 0 0 0 0 0 1 
1 0 0 0 0 0 0 1 1 1 1 1 1 1 1 1 1 1 1 1 0 0 0 0 0 0 1 
1 0 0 0 0 0 0 1 1 1 1 1 1 1 1 1 1 1 1 1 0 0 0 0 0 0 1 
1 0 0 0 0 0 0 1 1 1 1 1 1 1 1 1 1 1 1 1 0 0 0 0 0 0 1 
1 0 0 0 0 0 0 1 1 1 1 1 1 1 1 1 1 1 1 1 0 0 0 0 0 0 1 
1 1 1 0 0 0 1 1 1 1 1 1 1 1 1 1 1 1 1 1 1 0 0 0 1 1 1 
1 1 1 0 0 0 1 1 1 1 1 1 1 1 1 1 1 1 1 1 1 0 0 0 1 1 1 
1 1 1 0 0 0 1 1 1 0 0 0 0 0 0 0 0 0 1 1 1 0 0 0 1 1 1 
1 1 1 0 0 0 1 1 1 0 0 0 0 0 0 0 0 0 1 1 1 0 0 0 1 1 1 
1 1 1 0 0 0 1 1 1 0 0 0 0 0 0 0 0 0 1 1 1 0 0 0 1 1 1 
1 1 1 0 0 0 0 0 0 0 0 0 1 1 1 0 0 0 0 0 0 0 0 0 1 1 1 
1 1 1 0 0 0 0 0 0 0 0 0 1 1 1 0 0 0 0 0 0 0 0 0 1 1 1 
1 1 1 0 0 0 0 0 0 0 0 0 1 1 1 0 0 0 0 0 0 0 0 0 1 1 1 
1 1 1 1 1 1 1 1 1 0 0 0 0 0 0 0 0 0 1 1 1 1 1 1 1 1 1 
1 1 1 1 1 1 1 1 1 0 0 0 0 0 0 0 0 0 1 1 1 1 1 1 1 1 1 
1 1 1 1 1 1 1 1 1 0 0 0 0 0 0 0 0 0 1 1 1 1 1 1 1 1 1 
1 1 1 1 1 1 1 1 1 1 1 1 1 1 1 1 1 1 1 1 1 1 1 1 1 1 1 

20
2 12
2 13
2 14
4 3
4 4
4 5
4 21
4 22
4 23
7 1
8 1
7 25
8 25
16 3
17 3
16 23
17 23
13 12
13 13
13 13

3
2 12
2 13
2 14

40