19 9
19 21
0 0 26 31 31 31 28 0 0 0 0 0 26 31 31 31 28 0 0 
0 26 29 15 15 15 27 28 0 0 0 26 29 15 15 15 27 28 0 
26 29 5 10 10 10 5 27 28 0 26 29 5 10 10 10 5 27 28 
17 20 10 10 10 10 10 20 17 0 17 20 10 10 10 10 10 20 17 
17 10 10 10 10 10 10 10 17 0 17 10 10 10 10 10 10 10 17 
32 10 10 10 10 10 10 10 27 31 29 10 10 10 10 10 10 10 32 
32 10 10 10 10 10 10 10 5 15 5 10 10 10 10 10 10 10 32 
17 10 10 10 10 10 10 10 10 10 10 10 10 10 10 10 10 10 17 
17 10 10 10 10 10 10 10 10 10 10 10 10 10 10 10 10 10 17 
32 10 10 10 10 10 10 10 10 10 10 10 10 10 10 10 10 10 32 
32 10 10 10 10 10 10 30 30 30 30 30 10 10 10 10 10 10 32 
17 10 10 10 10 10 10 25 30 30 30 25 10 10 10 10 10 10 17 
27 28 10 10 10 10 10 10 25 30 25 10 10 10 10 10 10 26 29 
0 27 28 10 10 10 10 10 10 25 10 10 10 10 10 10 26 29 0 
0 0 27 28 10 10 10 10 10 10 10 10 10 10 10 26 29 0 0 
0 0 0 27 28 10 10 10 10 10 10 10 10 10 26 29 0 0 0 
0 0 0 0 27 28 10 10 10 10 10 10 10 26 29 0 0 0 0 
0 0 0 0 0 27 28 10 10 10 10 10 26 29 0 0 0 0 0 
0 0 0 0 0 0 27 28 10 10 10 26 29 0 0 0 0 0 0 
0 0 0 0 0 0 0 27 28 10 26 29 0 0 0 0 0 0 0 
0 0 0 0 0 0 0 0 27 23 29 0 0 0 0 0 0 0 0 
0 0 1 1 1 1 1 0 0 0 0 0 1 1 1 1 1 0 0 
0 1 1 1 1 1 1 1 0 0 0 1 1 1 1 1 1 1 0 
1 1 1 0 0 0 1 1 1 0 1 1 1 0 0 0 1 1 1 
1 1 0 0 0 0 0 1 1 0 1 1 0 0 0 0 0 1 1 
1 0 0 0 0 0 0 0 1 0 1 0 0 0 0 0 0 0 1 
1 0 0 0 0 0 0 0 1 1 1 0 0 0 0 0 0 0 1 
1 0 0 0 0 0 0 0 1 1 1 0 0 0 0 0 0 0 1 
1 0 0 0 0 0 0 0 0 0 0 0 0 0 0 0 0 0 1 
1 0 0 0 0 0 0 0 0 0 0 0 0 0 0 0 0 0 1 
0 0 0 0 0 0 0 0 0 0 0 0 0 0 0 0 0 0 1 
1 0 0 0 0 0 0 1 1 1 1 1 0 0 0 0 0 0 1 
1 0 0 0 0 0 0 1 1 1 1 1 0 0 0 0 0 0 1 
1 1 0 0 0 0 0 0 1 1 1 0 0 0 0 0 0 1 1 
1 1 1 0 0 0 0 0 0 1 0 0 0 0 0 0 1 1 1 
1 1 1 1 0 0 0 0 0 0 0 0 0 0 0 1 1 1 1 
1 1 1 1 1 0 0 0 0 0 0 0 0 0 1 1 1 1 1 
1 1 1 1 1 1 0 0 0 0 0 0 0 1 1 1 1 1 1 
1 1 1 1 1 1 1 0 0 0 0 0 1 1 1 1 1 1 1 
1 1 1 1 1 1 1 1 0 0 0 1 1 1 1 1 1 1 1 
1 1 1 1 1 1 1 1 1 0 1 1 1 1 1 1 1 1 1 
1 1 1 1 1 1 1 1 1 1 1 1 1 1 1 1 1 1 1 

15
2 3
2 4
2 5
2 13
2 14
2 15
7 9
5 1
6 1
5 17
6 17
9 1
10 1
9 17
10 17

1
7 9

60
