16 12
26 18
26 23 23 31 31 23 23 28 0 26 23 23 31 31 23 23 28 0 26 23 23 31 31 23 23 28 
17 5 5 15 15 5 5 17 0 17 5 5 15 15 5 5 17 0 17 5 5 15 15 5 5 17 
17 10 10 10 10 10 10 17 0 17 10 10 10 10 10 10 17 0 17 10 10 10 10 10 10 17 
17 10 10 10 10 10 10 17 0 17 10 10 10 10 10 10 17 0 17 10 10 10 10 10 10 17 
32 10 10 30 30 10 10 27 23 29 10 10 10 10 10 10 27 23 29 10 10 30 30 10 10 32 
32 10 10 25 25 10 10 5 20 5 10 10 30 30 10 10 5 20 5 10 10 25 25 10 10 32 
17 10 10 10 10 10 10 10 10 10 10 10 25 25 10 10 10 10 10 10 10 10 10 10 10 17 
17 10 10 10 10 10 10 10 10 10 10 10 10 10 10 10 10 10 10 10 10 10 10 10 10 17 
27 23 23 23 23 23 28 10 10 10 10 10 10 10 10 10 10 10 10 26 23 23 23 23 23 29 
26 23 23 23 23 23 29 10 10 10 10 10 10 10 10 10 10 10 10 27 23 23 23 23 23 28 
17 5 20 5 5 20 5 10 10 10 10 10 10 10 10 10 10 10 10 5 20 5 5 20 5 17 
17 10 10 10 10 10 10 10 10 10 10 10 10 10 10 10 10 10 10 10 10 10 10 10 10 17 
17 10 10 10 10 10 10 10 10 10 10 10 30 30 10 10 10 10 10 10 10 10 10 10 10 17 
32 10 10 30 30 10 10 26 23 28 10 10 25 25 10 10 26 23 28 10 10 30 30 10 10 32 
32 10 10 25 25 10 10 17 0 17 10 10 10 10 10 10 17 0 17 10 10 25 25 10 10 32 
17 10 10 10 10 10 10 17 0 17 10 10 10 10 10 10 17 0 17 10 10 10 10 10 10 17 
17 10 10 10 10 10 10 17 0 17 10 10 10 10 10 10 17 0 17 10 10 10 10 10 10 17 
27 23 23 31 31 23 23 29 0 27 23 23 23 23 23 23 29 0 27 23 23 31 31 23 23 29 
1 1 1 1 1 1 1 1 0 1 1 1 1 1 1 1 1 0 1 1 1 1 1 1 1 1 
1 1 1 1 1 1 1 1 0 1 1 1 1 1 1 1 1 0 1 1 1 1 1 1 1 1 
1 0 0 0 0 0 0 1 0 1 0 0 0 0 0 0 1 0 1 0 0 0 0 0 0 1 
1 0 0 0 0 0 0 1 0 1 0 0 0 0 0 0 1 0 1 0 0 0 0 0 0 1 
1 0 0 1 1 0 0 1 1 1 0 0 0 0 0 0 1 1 1 0 0 1 1 0 0 1 
1 0 0 1 1 0 0 1 1 1 0 0 1 1 0 0 1 1 1 0 0 1 1 0 0 1 
1 0 0 0 0 0 0 0 0 0 0 0 1 1 0 0 0 0 0 0 0 0 0 0 0 1 
1 0 0 0 0 0 0 0 0 0 0 0 0 0 0 0 0 0 0 0 0 0 0 0 0 1 
1 1 1 1 1 1 1 0 0 0 0 0 0 0 0 0 0 0 0 1 1 1 1 1 1 1 
1 1 1 1 1 1 1 0 0 0 0 0 0 0 0 0 0 0 0 1 1 1 1 1 1 1 
1 1 1 1 1 1 1 0 0 0 0 0 0 0 0 0 0 0 0 1 1 1 1 1 1 1 
1 0 0 0 0 0 0 0 0 0 0 0 0 0 0 0 0 0 0 0 0 0 0 0 0 1 
1 0 0 0 0 0 0 0 0 0 0 0 1 1 0 0 0 0 0 0 0 0 0 0 0 1 
1 0 0 1 1 0 0 1 1 1 0 0 1 1 0 0 1 1 1 0 0 1 1 0 0 1 
1 0 0 1 1 0 0 1 0 1 0 0 0 0 0 0 1 0 1 0 0 1 1 0 0 1 
1 0 0 0 0 0 0 1 0 1 0 0 0 0 0 0 1 0 1 0 0 0 0 0 0 1 
1 0 0 0 0 0 0 1 0 1 0 0 0 0 0 0 1 0 1 0 0 0 0 0 0 1 
1 1 1 1 1 1 1 1 0 1 1 1 1 1 1 1 1 0 1 1 1 1 1 1 1 1 

18
2 3
2 4
2 12
2 13
2 21
2 22
16 3
16 4
16 21
16 22
4 1
5 1
13 1
14 1
4 24
5 24
13 24
14 24

2
2 12
2 13

60