16 12
25 24
26 23 23 31 31 23 23 28 0 0 26 23 31 23 28 0 0 26 23 23 31 31 23 23 28 
17 20 5 15 15 5 20 17 0 0 17 5 15 5 17 0 0 17 20 5 15 15 5 20 17 
17 10 10 10 10 10 10 17 0 0 17 10 10 10 17 0 0 17 10 10 10 10 10 10 17 
17 10 10 10 10 10 10 17 0 0 17 10 10 10 17 0 0 17 10 10 10 10 10 10 17 
32 10 10 10 10 10 10 27 23 23 29 10 10 10 27 23 23 29 10 10 10 10 10 10 32 
32 10 10 10 10 10 10 10 10 10 10 10 10 10 10 10 10 10 10 10 10 10 10 10 32 
17 10 10 10 10 10 10 10 10 10 10 10 10 10 10 10 10 10 10 10 10 10 10 10 17 
17 10 10 10 10 10 10 10 10 10 10 10 10 10 10 10 10 10 10 10 10 10 10 10 17 
27 23 23 28 10 10 10 26 23 23 28 10 10 10 26 23 23 28 10 10 10 26 23 23 29 
0 0 0 17 10 10 10 17 26 23 29 10 10 10 27 23 28 17 10 10 10 17 0 0 0 
0 0 0 17 10 10 10 17 17 20 5 10 10 10 5 20 17 17 10 10 10 17 0 0 0 
0 0 0 17 10 10 10 17 17 10 10 10 10 10 10 10 17 17 10 10 10 17 0 0 0 
0 0 0 17 10 10 10 17 17 10 10 10 10 10 10 10 17 17 10 10 10 17 0 0 0 
0 0 0 17 10 10 10 17 32 10 10 10 10 10 10 10 32 17 10 10 10 17 0 0 0 
0 0 0 17 10 10 10 17 32 10 10 10 10 10 10 10 32 17 10 10 10 17 0 0 0 
0 0 0 17 10 10 10 17 17 10 10 10 10 10 10 10 17 17 10 10 10 17 0 0 0 
0 0 0 17 10 10 10 17 17 10 10 10 10 10 10 10 17 17 10 10 10 17 0 0 0 
0 0 0 17 10 10 10 17 27 23 23 23 23 23 23 23 29 17 10 10 10 17 0 0 0 
0 0 0 17 10 10 10 27 23 23 31 23 23 23 31 23 23 29 10 10 10 17 0 0 0 
0 0 0 17 10 10 10 5 20 5 15 5 20 5 15 5 20 5 10 10 10 17 0 0 0 
0 0 0 17 10 10 10 10 10 10 10 10 10 10 10 10 10 10 10 10 10 17 0 0 0 
0 0 0 17 10 10 10 10 10 10 10 10 10 10 10 10 10 10 10 10 10 17 0 0 0 
0 0 0 17 10 10 10 10 10 10 10 10 10 10 10 10 10 10 10 10 10 17 0 0 0 
0 0 0 27 23 31 31 31 23 23 23 31 31 31 23 23 23 31 31 31 23 29 0 0 0 
 
1 1 1 1 1 1 1 1 0 0 1 1 1 1 1 0 0 1 1 1 1 1 1 1 1 
1 1 1 1 1 1 1 1 0 0 1 1 1 1 1 0 0 1 1 1 1 1 1 1 1 
1 0 0 0 0 0 0 1 0 0 1 0 0 0 1 0 0 1 0 0 0 0 0 0 1 
1 0 0 0 0 0 0 1 0 0 1 0 0 0 1 0 0 1 0 0 0 0 0 0 1 
1 0 0 0 0 0 0 1 1 1 1 0 0 0 1 1 1 1 0 0 0 0 0 0 1 
1 0 0 0 0 0 0 0 0 0 0 0 0 0 0 0 0 0 0 0 0 0 0 0 1 
1 0 0 0 0 0 0 0 0 0 0 0 0 0 0 0 0 0 0 0 0 0 0 0 1 
1 0 0 0 0 0 0 0 0 0 0 0 0 0 0 0 0 0 0 0 0 0 0 0 1 
1 1 1 1 0 0 0 1 1 1 1 0 0 0 1 1 1 1 0 0 0 1 1 1 1 
0 0 0 1 0 0 0 1 1 1 1 0 0 0 1 1 1 1 0 0 0 1 0 0 0 
0 0 0 1 0 0 0 1 1 1 1 0 0 0 1 1 1 1 0 0 0 1 0 0 0 
0 0 0 1 0 0 0 1 1 0 0 0 0 0 0 0 1 1 0 0 0 1 0 0 0 
0 0 0 1 0 0 0 1 1 0 0 0 0 0 0 0 1 1 0 0 0 1 0 0 0 
0 0 0 1 0 0 0 1 1 0 0 0 0 0 0 0 1 1 0 0 0 1 0 0 0 
0 0 0 1 0 0 0 1 1 0 0 0 0 0 0 0 1 1 0 0 0 1 0 0 0 
0 0 0 1 0 0 0 1 1 0 0 0 0 0 0 0 1 1 0 0 0 1 0 0 0 
0 0 0 1 0 0 0 1 1 0 0 0 0 0 0 0 1 1 0 0 0 1 0 0 0 
0 0 0 1 0 0 0 1 1 1 1 1 1 1 1 1 1 1 0 0 0 1 0 0 0 
0 0 0 1 0 0 0 1 1 1 1 1 1 1 1 1 1 1 0 0 0 1 0 0 0 
0 0 0 1 0 0 0 1 1 1 1 1 1 1 1 1 1 1 0 0 0 1 0 0 0 
0 0 0 1 0 0 0 0 0 0 0 0 0 0 0 0 0 0 0 0 0 1 0 0 0 
0 0 0 1 0 0 0 0 0 0 0 0 0 0 0 0 0 0 0 0 0 1 0 0 0 
0 0 0 1 0 0 0 0 0 0 0 0 0 0 0 0 0 0 0 0 0 1 0 0 0 
0 0 0 1 1 1 1 1 1 1 1 1 1 1 1 1 1 1 1 1 1 1 0 0 0 

24
2 12 
2 3 
2 4 
2 20 
2 21
4 1 
4 23
5 1 
5 23
13 9 
13 15
14 9 
14 15
20 10
20 14
22 5
22 6
22 7
22 11
22 12
22 13
22 17
22 18
22 19


1
2 12

50