20 15
31 22
0 0 0 0 0 0 0 0 0 0 26 23 23 23 31 31 31 23 23 23 28 0 0 0 0 0 0 0 0 0 0 
0 0 0 0 0 0 0 0 0 0 17 5 20 5 15 15 15 5 20 5 17 0 0 0 0 0 0 0 0 0 0 
0 0 0 0 0 0 0 0 0 0 17 10 10 10 10 10 10 10 10 10 17 0 0 0 0 0 0 0 0 0 0 
0 0 0 0 0 0 0 0 0 0 17 10 10 10 10 10 10 10 10 10 17 0 0 0 0 0 0 0 0 0 0 
0 0 0 0 0 0 0 0 0 0 17 10 10 25 10 10 10 10 10 10 17 0 0 0 0 0 0 0 0 0 0 
0 0 0 0 0 0 0 0 0 0 32 10 10 10 10 10 10 10 10 10 32 0 0 0 0 0 0 0 0 0 0 
0 0 0 0 0 0 0 0 0 0 32 10 10 10 10 10 10 10 10 10 32 0 0 0 0 0 0 0 0 0 0 
0 0 0 0 0 0 0 0 0 0 32 10 10 10 10 10 10 10 10 10 32 0 0 0 0 0 0 0 0 0 0 
0 0 0 0 0 0 0 0 0 0 17 10 10 10 10 10 10 25 10 10 17 0 0 0 0 0 0 0 0 0 0 
0 0 0 0 0 0 0 0 0 0 17 10 10 10 10 10 10 10 10 10 17 0 0 0 0 0 0 0 0 0 0 
26 23 23 23 31 31 31 23 23 23 29 10 10 10 10 10 10 10 10 10 27 23 23 23 31 31 31 23 23 23 28 
17 5 20 5 15 15 15 5 20 5 5 25 25 10 10 10 10 10 25 25 5 5 20 5 15 15 15 5 20 5 17 
17 10 10 10 10 10 10 10 10 10 30 10 10 10 10 10 10 10 10 10 30 10 10 10 10 10 10 10 10 10 17 
17 10 10 10 10 10 10 10 10 10 25 10 10 10 10 10 10 10 10 10 25 10 10 10 10 10 10 10 10 10 17 
17 10 10 25 10 10 10 10 10 10 10 10 10 10 10 10 10 10 10 10 10 10 10 10 10 10 10 10 10 10 17 
32 10 10 10 10 10 10 10 10 10 10 10 10 10 10 10 10 25 10 10 10 10 10 25 10 10 10 10 10 10 32 
32 10 10 10 10 10 10 10 10 10 10 10 10 10 10 10 10 10 10 10 10 10 10 10 10 10 10 10 10 10 32 
32 10 10 10 10 10 10 10 10 10 10 10 10 25 10 10 10 10 10 10 10 10 10 10 10 10 10 10 10 10 32 
17 10 10 10 10 10 10 25 10 10 10 10 10 10 10 10 10 10 10 10 10 10 10 10 10 10 10 25 10 10 17 
17 10 10 10 10 10 10 10 10 10 30 10 10 10 10 10 10 10 10 10 30 10 10 10 10 10 10 10 10 10 17 
17 10 10 10 10 10 10 10 10 10 30 10 10 10 10 10 10 10 10 10 30 10 10 10 10 10 10 10 10 10 17 
27 23 23 23 31 31 31 23 23 23 23 23 23 23 23 23 23 23 23 23 23 23 23 23 31 31 31 23 23 23 29 
0 0 0 0 0 0 0 0 0 0 1 1 1 1 1 1 1 1 1 1 1 0 0 0 0 0 0 0 0 0 0 
0 0 0 0 0 0 0 0 0 0 1 1 1 1 1 1 1 1 1 1 1 0 0 0 0 0 0 0 0 0 0 
0 0 0 0 0 0 0 0 0 0 1 0 0 0 0 0 0 0 0 0 1 0 0 0 0 0 0 0 0 0 0 
0 0 0 0 0 0 0 0 0 0 1 0 0 0 0 0 0 0 0 0 1 0 0 0 0 0 0 0 0 0 0 
0 0 0 0 0 0 0 0 0 0 1 0 0 1 0 0 0 0 0 0 1 0 0 0 0 0 0 0 0 0 0 
0 0 0 0 0 0 0 0 0 0 1 0 0 0 0 0 0 0 0 0 1 0 0 0 0 0 0 0 0 0 0 
0 0 0 0 0 0 0 0 0 0 1 0 0 0 0 0 0 0 0 0 1 0 0 0 0 0 0 0 0 0 0 
0 0 0 0 0 0 0 0 0 0 1 0 0 0 0 0 0 0 0 0 1 0 0 0 0 0 0 0 0 0 0 
0 0 0 0 0 0 0 0 0 0 1 0 0 0 0 0 0 1 0 0 1 0 0 0 0 0 0 0 0 0 0 
0 0 0 0 0 0 0 0 0 0 1 0 0 0 0 0 0 0 0 0 1 0 0 0 0 0 0 0 0 0 0 
1 1 1 1 1 1 1 1 1 1 1 0 0 0 0 0 0 0 0 0 1 1 1 1 1 1 1 1 1 1 1 
1 1 1 1 1 1 1 1 1 1 1 1 1 0 0 0 0 0 1 1 1 1 1 1 1 1 1 1 1 1 1 
1 0 0 0 0 0 0 0 0 0 1 0 0 0 0 0 0 0 0 0 1 0 0 0 0 0 0 0 0 0 1 
1 0 0 0 0 0 0 0 0 0 1 0 0 0 0 0 0 0 0 0 1 0 0 0 0 0 0 0 0 0 1 
1 0 0 1 0 0 0 0 0 0 0 0 0 0 0 0 0 0 0 0 0 0 0 0 0 0 0 0 0 0 1 
1 0 0 0 0 0 0 0 0 0 0 0 0 0 0 0 0 1 0 0 0 0 0 1 0 0 0 0 0 0 1 
1 0 0 0 0 0 0 0 0 0 0 0 0 0 0 0 0 0 0 0 0 0 0 0 0 0 0 0 0 0 1 
1 0 0 0 0 0 0 0 0 0 0 0 0 1 0 0 0 0 0 0 0 0 0 0 0 0 0 0 0 0 1 
1 0 0 0 0 0 0 1 0 0 0 0 0 0 0 0 0 0 0 0 0 0 0 0 0 0 0 1 0 0 1 
1 0 0 0 0 0 0 0 0 0 1 0 0 0 0 0 0 0 0 0 1 0 0 0 0 0 0 0 0 0 1 
1 0 0 0 0 0 0 0 0 0 1 0 0 0 0 0 0 0 0 0 1 0 0 0 0 0 0 0 0 0 1 
1 1 1 1 1 1 1 1 1 1 1 1 1 1 1 1 1 1 1 1 1 1 1 1 1 1 1 1 1 1 1 

27
2 14 2 15 2 16
5 11 6 11 7 11
5 19 6 19 7 19
12 4 12 5 12 6
12 24 12 25 12 26
15 1 16 1 17 1
15 30 16 30 17 30
20 4 20 5 20 6
20 24 20 25 20 26

3
2 14 2 15 2 16
45