12 11
23 22
0 0 0 0 0 0 0 0 26 23 31 31 31 23 28 0 0 0 0 0 0 0 0 
26 23 23 23 23 23 23 23 29 5 15 15 15 5 17 0 0 0 0 0 0 0 0 
17 5 5 20 5 5 20 5 5 10 10 10 10 10 17 0 0 0 0 0 0 0 0 
17 10 10 10 10 10 10 10 10 10 10 10 10 10 32 0 0 0 0 0 0 0 0 
17 10 10 10 10 10 10 10 10 10 10 10 10 10 32 0 0 0 0 0 0 0 0 
17 10 10 10 10 10 10 10 10 10 10 10 10 10 32 0 0 0 0 0 0 0 0 
17 10 10 10 26 23 23 23 28 10 10 10 10 10 17 0 0 0 0 0 0 0 0 
17 10 10 10 17 0 0 0 27 23 31 31 31 23 29 0 0 0 0 0 0 0 0 
17 10 10 10 27 23 23 23 23 23 23 23 23 23 23 23 23 23 23 23 23 23 28 
17 10 10 10 5 5 20 5 5 20 5 5 20 5 5 20 5 5 20 5 5 5 17 
17 10 10 10 10 10 10 10 10 10 10 10 10 10 10 10 10 10 10 10 10 10 17 
32 10 10 10 10 10 10 10 10 10 10 10 10 10 10 10 10 10 10 10 10 10 32
17 10 10 10 10 10 10 10 10 10 10 10 10 10 10 10 10 10 10 10 10 10 17 
27 23 23 23 23 23 23 23 23 23 23 23 23 23 23 23 23 23 28 10 10 10 17 
0 0 0 0 0 0 0 0 26 23 31 31 31 23 28 0 0 0 17 10 10 10 17 
0 0 0 0 0 0 0 0 17 5 15 15 15 5 27 23 23 23 29 10 10 10 17 
0 0 0 0 0 0 0 0 17 10 10 10 10 10 5 5 20 5 5 10 10 10 17 
0 0 0 0 0 0 0 0 32 10 10 10 10 10 10 10 10 10 10 10 10 10 17 
0 0 0 0 0 0 0 0 32 10 10 10 10 10 10 10 10 10 10 10 10 10 17 
0 0 0 0 0 0 0 0 32 10 10 10 10 10 10 10 10 10 10 10 10 10 17 
0 0 0 0 0 0 0 0 17 10 10 10 10 10 26 23 23 23 23 23 23 23 29 
0 0 0 0 0 0 0 0 27 23 31 31 31 23 29 0 0 0 0 0 0 0 0 
0 0 0 0 0 0 0 0 1 1 1 1 1 1 1 0 0 0 0 0 0 0 0 
1 1 1 1 1 1 1 1 1 1 1 1 1 1 1 0 0 0 0 0 0 0 0 
1 1 1 1 1 1 1 1 1 0 0 0 0 0 1 0 0 0 0 0 0 0 0 
1 0 0 0 0 0 0 0 0 0 0 0 0 0 1 0 0 0 0 0 0 0 0 
1 0 0 0 0 0 0 0 0 0 0 0 0 0 1 0 0 0 0 0 0 0 0 
1 0 0 0 0 0 0 0 0 0 0 0 0 0 1 0 0 0 0 0 0 0 0 
1 0 0 0 1 1 1 1 1 0 0 0 0 0 1 0 0 0 0 0 0 0 0 
1 0 0 0 1 0 0 0 1 1 1 1 1 1 1 0 0 0 0 0 0 0 0 
1 0 0 0 1 1 1 1 1 1 1 1 1 1 1 1 1 1 1 1 1 1 1 
1 0 0 0 1 1 1 1 1 1 1 1 1 1 1 1 1 1 1 1 1 1 1 
1 0 0 0 0 0 0 0 0 0 0 0 0 0 0 0 0 0 0 0 0 0 1 
1 0 0 0 0 0 0 0 0 0 0 0 0 0 0 0 0 0 0 0 0 0 1 
1 0 0 0 0 0 0 0 0 0 0 0 0 0 0 0 0 0 0 0 0 0 1 
1 1 1 1 1 1 1 1 1 1 1 1 1 1 1 1 1 1 1 0 0 0 1 
0 0 0 0 0 0 0 0 1 1 1 1 1 1 1 0 0 0 1 0 0 0 1 
0 0 0 0 0 0 0 0 1 1 1 1 1 1 1 1 1 1 1 0 0 0 1 
0 0 0 0 0 0 0 0 1 0 0 0 0 0 1 1 1 1 1 0 0 0 1 
0 0 0 0 0 0 0 0 1 0 0 0 0 0 0 0 0 0 0 0 0 0 1 
0 0 0 0 0 0 0 0 1 0 0 0 0 0 0 0 0 0 0 0 0 0 1 
0 0 0 0 0 0 0 0 1 0 0 0 0 0 0 0 0 0 0 0 0 0 1 
0 0 0 0 0 0 0 0 1 0 0 0 0 0 1 1 1 1 1 1 1 1 1 
0 0 0 0 0 0 0 0 1 1 1 1 1 1 1 0 0 0 0 0 0 0 0 

20
2 10 
2 11 
2 12
6 10 
6 11 
6 12
3 13 
4 13 
5 13
16 10 
16 11 
16 12
20 10 
20 11 
20 12
19 9 
18 9 
17 9
11 1
11 21

3
2 10 2 11 2 12

55