13 6
14 15
26 23 23 23 23 23 31 31 23 23 23 23 23 28 
17 5 5 20 5 5 15 15 5 5 20 5 5 17 
17 10 10 10 10 10 10 10 10 10 10 10 10 17 
17 10 10 10 10 10 10 10 10 10 10 10 10 17 
17 10 10 25 10 10 10 10 10 10 25 10 10 17 
17 10 10 10 10 10 10 10 10 10 10 10 10 17 
17 10 10 10 10 10 10 10 10 10 10 10 10 17 
32 10 10 10 10 10 30 30 10 10 10 10 10 32 
32 10 10 10 10 10 25 25 10 10 10 10 10 32 
17 10 10 10 10 10 10 10 10 10 10 10 10 17 
17 10 10 10 10 10 10 10 10 10 10 10 10 17 
17 10 10 25 10 10 10 10 10 10 25 10 10 17 
17 10 10 10 10 10 10 10 10 10 10 10 10 17 
17 10 10 10 10 10 10 10 10 10 10 10 10 17 
27 23 31 31 23 23 23 23 23 23 31 31 23 29 
1 1 1 1 1 1 1 1 1 1 1 1 1 1 
1 1 1 1 1 1 1 1 1 1 1 1 1 1 
1 0 0 0 0 0 0 0 0 0 0 0 0 1 
1 0 0 0 0 0 0 0 0 0 0 0 0 1 
1 0 0 1 0 0 0 0 0 0 1 0 0 1 
1 0 0 0 0 0 0 0 0 0 0 0 0 1 
1 0 0 0 0 0 0 0 0 0 0 0 0 1 
1 0 0 0 0 0 1 1 0 0 0 0 0 1 
1 0 0 0 0 0 1 1 0 0 0 0 0 1 
1 0 0 0 0 0 0 0 0 0 0 0 0 1 
1 0 0 0 0 0 0 0 0 0 0 0 0 1 
1 0 0 1 0 0 0 0 0 0 1 0 0 1 
1 0 0 0 0 0 0 0 0 0 0 0 0 1 
1 0 0 0 0 0 0 0 0 0 0 0 0 1 
1 1 1 1 1 1 1 1 1 1 1 1 1 1 

10
2 7
2 6
7 1
8 1
13 2
13 3
13 11
13 12
7 12
8 12

2
2 7
2 6

30